size 18 17
иииииииииииииииииии
иииииииииииииииииии
ии###############ии
ии#.............#ии
ии#.............#ии
ии#.............#ии
ии#.............#ии
ии#.............#ии
===.............#ии
===............>#ии
===.............#ии
ии#.............#ии
ии#.............#ии
ии#.............#ии
ии#.............#ии
ии#.............#ии
ии###############ии
иииииииииииииииииии
иииииииииииииииииии
 