size 19 15
       ##<##       
       #...#       
########...########
#......#...#......#
u......+...+......u
#......#...#......#
########...########
       #...#       
       u...u       
       #...#       
########...########
#......#...#......#
u......+...+......u
#......#...#......#
#########u#########
 
size 11 11
#####u#####
#.........#
#.........#
#.........#
#.........#
u....<....u
#.........#
#.........#
#.........#
#.........#
#####u#####
 