size 19 15
       ##<##       
       #...#       
########...########
#......#...#......#
u......+...+......u
#......#...#......#
########...########
       #...#       
       u...u       
       #...#       
########...########
#......#...#......#
u......+...+......u
#......#...#......#
#########u#########
 